A	ÀÁÂÃÄÅĀĂĄǍǺ
a	àáâãäåāăąǎǻ
AE	ÆǼ
ae	æǽ
C	ÇĆĈĊČ
c	çćĉċč
D	ÐĎ
d	ðď
E	ÈÉÊË
e	èéêë
P|B	Þ
p|b	þ
G	ĠĢ
g	ġģǵ
H	ĤĦ
h	ħĥ
I	ÌÍÎÏ	ĨĪĬĮİǏ
i	ìíîï	ĩīĭįıǐ
IJ	Ĳ
ij	ĳ
J	Ĵ
j	ĵ
K	Ķ
k	ķĸ
L	ĹĻĽĿŁ
l	ĺļľŀł
N	ŃŅŇÑ
n	ńņňŉñ
NG	Ŋ
ng	ŋ
O	ÒÓÔÕÖØǾŌŎŐǑ
o	òóôõöøǿōŏőǒ
OE	Œ
oe	œ
R	ŔŖŘ
r	ŕŗř
S	ŚŜŞŠ
s	śŝşš
T	ŢŤŦ
t	ţťŧ
U	ÙÚÛÜŨŪŬŮŰŲǓǕǗǙǛ
u	ùúûüũūŭůűųǔǖǘǚǜ
W	ŴẀẂẄ
w	ẁẃẅŵ
Y	ŶỲÝŸ
y	ŷỳýÿ
Z	ŹŻŽ
z	źżž
